//MAP CONVERTED BY dmm2tgm.py THIS HEADER COMMENT PREVENTS RECONVERSION, DO NOT REMOVE
"a" = (
/turf/closed/wall/mineral/titanium/survival/pod,
/area/misc/survivalpod)
"b" = (
/obj/effect/turf_decal/mining/survival{
	dir = 1
	},
/turf/closed/wall/mineral/titanium/survival/pod,
/area/misc/survivalpod)
"c" = (
/obj/structure/fans/tiny,
/obj/machinery/door/airlock/survival_pod/glass,
/turf/open/floor/carpet/black,
/area/misc/survivalpod)
"d" = (
/obj/machinery/porta_turret/syndicate/energy,
/turf/closed/wall/mineral/titanium/survival/pod,
/area/misc/survivalpod)
"e" = (
/obj/effect/turf_decal/mining/survival{
	dir = 8
	},
/turf/closed/wall/mineral/titanium/survival/nodiagonal,
/area/misc/survivalpod)
"f" = (
/obj/machinery/door/airlock/highsecurity,
/turf/open/floor/pod/dark,
/area/misc/survivalpod)
"h" = (
/obj/structure/window/reinforced/survival_pod/spawner/directional/west,
/obj/structure/window/reinforced/survival_pod/spawner/directional/east,
/obj/structure/window/reinforced/survival_pod/spawner/directional/north,
/obj/structure/window/reinforced/survival_pod/spawner/directional/south,
/obj/structure/grille,
/turf/open/space/basic,
/area/misc/survivalpod)
"i" = (
/obj/effect/turf_decal/stripes{
	dir = 8
	},
/obj/machinery/door/poddoor/shutters/syndicate{
	dir = 8;
	id = syndie_pod_door
	},
/turf/open/floor/engine,
/area/misc/survivalpod)
"j" = (
/obj/machinery/light/directional/east,
/obj/structure/closet/crate,
/turf/open/floor/pod/dark,
/area/misc/survivalpod)
"k" = (
/obj/structure/table/wood/fancy/black,
/obj/item/storage/box/donkpockets,
/obj/item/storage/box/donkpockets/donkpockethonk,
/obj/item/storage/box/donkpockets/donkpocketpizza,
/obj/item/storage/box/donkpockets/donkpocketspicy,
/obj/item/storage/box/donkpockets/donkpocketberry,
/turf/open/floor/pod/dark,
/area/misc/survivalpod)
"l" = (
/obj/machinery/light/directional/north,
/turf/open/floor/pod/dark,
/area/misc/survivalpod)
"m" = (
/obj/machinery/stasis{
	dir = 4
	},
/turf/open/floor/pod/dark,
/area/misc/survivalpod)
"n" = (
/obj/structure/table/wood/fancy/black,
/obj/item/reagent_containers/cup/glass/shaker,
/obj/item/reagent_containers/cup/rag,
/obj/item/book/manual/wiki/barman_recipes,
/turf/open/floor/pod/dark,
/area/misc/survivalpod)
"o" = (
/obj/structure/table,
/obj/item/storage/medkit/toxin{
	pixel_x = 3;
	pixel_y = 3
	},
/obj/item/storage/medkit/brute,
/obj/item/storage/medkit/fire{
	pixel_x = -3;
	pixel_y = -3
	},
/turf/open/floor/pod/dark,
/area/misc/survivalpod)
"p" = (
/obj/effect/turf_decal/stripes{
	dir = 1
	},
/obj/machinery/door/poddoor/shutters/syndicate{
	dir = 1;
	id = syndie_pod_door
	},
/turf/open/floor/engine,
/area/misc/survivalpod)
"q" = (
/turf/open/floor/pod/dark,
/area/misc/survivalpod)
"r" = (
/obj/effect/turf_decal/stripes{
	dir = 4
	},
/obj/machinery/door/poddoor/shutters/syndicate{
	dir = 4;
	id = syndie_pod_door
	},
/turf/open/floor/engine,
/area/misc/survivalpod)
"t" = (
/obj/machinery/light/directional/south,
/turf/open/floor/plating,
/area/misc/survivalpod)
"u" = (
/obj/effect/turf_decal/mining/survival{
	dir = 8
	},
/turf/closed/wall/mineral/titanium/survival/pod,
/area/misc/survivalpod)
"v" = (
/turf/open/floor/engine,
/area/misc/survivalpod)
"w" = (
/obj/machinery/vending/cigarette,
/turf/open/floor/pod/dark,
/area/misc/survivalpod)
"x" = (
/obj/structure/table/wood/fancy/black,
/obj/machinery/microwave,
/turf/open/floor/pod/dark,
/area/misc/survivalpod)
"y" = (
/obj/structure/table/optable,
/obj/machinery/defibrillator_mount/directional/west,
/turf/open/floor/pod/dark,
/area/misc/survivalpod)
"z" = (
/obj/machinery/button/door{
	id = syndie_pod_door
	},
/turf/closed/wall/mineral/titanium/survival/pod,
/area/misc/survivalpod)
"B" = (
/obj/machinery/vending/boozeomat,
/turf/open/floor/pod/dark,
/area/misc/survivalpod)
"C" = (
/obj/structure/window/reinforced/survival_pod/spawner/directional/west,
/obj/structure/window/reinforced/survival_pod/spawner/directional/east,
/obj/structure/window/reinforced/survival_pod/spawner/directional/north,
/obj/structure/window/reinforced/survival_pod/spawner/directional/south,
/obj/structure/grille,
/turf/open/floor/pod/dark,
/area/misc/survivalpod)
"D" = (
/obj/machinery/recharge_station,
/turf/open/floor/pod/dark,
/area/misc/survivalpod)
"E" = (
/obj/structure/table/wood/fancy/black,
/obj/machinery/chem_dispenser/drinks/beer,
/obj/machinery/light/directional/north,
/turf/open/floor/pod/dark,
/area/misc/survivalpod)
"F" = (
/obj/item/kirbyplants/random,
/turf/open/floor/pod/dark,
/area/misc/survivalpod)
"G" = (
/obj/structure/table/reinforced,
/obj/machinery/recharger,
/turf/open/floor/pod/dark,
/area/misc/survivalpod)
"H" = (
/obj/machinery/vending/snack/blue,
/turf/open/floor/pod/dark,
/area/misc/survivalpod)
"I" = (
/obj/machinery/light/directional/west,
/obj/machinery/suit_storage_unit/standard_unit,
/turf/open/floor/pod/dark,
/area/misc/survivalpod)
"K" = (
/obj/structure/table,
/obj/item/defibrillator/loaded{
	pixel_y = 3
	},
/turf/open/floor/pod/dark,
/area/misc/survivalpod)
"L" = (
/obj/effect/turf_decal/stripes,
/obj/machinery/door/poddoor/shutters/syndicate{
	id = syndie_pod_door
	},
/turf/open/floor/engine,
/area/misc/survivalpod)
"N" = (
/obj/structure/bed/medical,
/turf/open/floor/pod/dark,
/area/misc/survivalpod)
"O" = (
/obj/effect/turf_decal/mining/survival{
	dir = 4
	},
/turf/closed/wall/mineral/titanium/survival/pod,
/area/misc/survivalpod)
"P" = (
/obj/effect/turf_decal/mining/survival,
/turf/closed/wall/mineral/titanium/survival/pod,
/area/misc/survivalpod)
"R" = (
/obj/machinery/teleport/syndicate_gate,
/turf/open/floor/engine,
/area/misc/survivalpod)
"S" = (
/turf/open/floor/plating,
/area/misc/survivalpod)
"T" = (
/obj/machinery/computer/operating,
/turf/open/floor/pod/dark,
/area/misc/survivalpod)
"V" = (
/obj/structure/closet/crate,
/turf/open/floor/pod/dark,
/area/misc/survivalpod)
"X" = (
/obj/structure/table,
/obj/item/storage/medkit/o2{
	pixel_x = 3;
	pixel_y = 3
	},
/obj/item/storage/medkit,
/turf/open/floor/pod/dark,
/area/misc/survivalpod)
"Y" = (
/obj/item/storage/backpack/duffelbag/syndie/surgery,
/obj/structure/table,
/turf/open/floor/pod/dark,
/area/misc/survivalpod)
"Z" = (
/obj/structure/table/wood/fancy/black,
/obj/machinery/chem_dispenser/drinks,
/turf/open/floor/pod/dark,
/area/misc/survivalpod)

(1,1,1) = {"
d
u
a
C
a
u
a
C
d
C
a
u
a
C
a
e
d
"}
(2,1,1) = {"
b
Z
q
q
q
H
a
I
q
I
a
S
S
S
S
S
a
"}
(3,1,1) = {"
a
E
q
q
q
x
a
G
q
G
a
S
S
S
S
S
a
"}
(4,1,1) = {"
C
q
q
q
q
q
q
q
q
q
q
S
S
S
S
S
C
"}
(5,1,1) = {"
a
B
q
q
q
k
a
q
q
q
a
S
S
S
S
S
a
"}
(6,1,1) = {"
b
n
q
q
q
w
a
D
q
D
a
S
S
S
S
S
a
"}
(7,1,1) = {"
a
a
a
f
a
a
a
i
i
i
z
S
S
S
S
S
d
"}
(8,1,1) = {"
C
q
q
q
q
q
p
v
v
v
L
S
S
S
S
t
h
"}
(9,1,1) = {"
d
l
q
q
q
q
p
v
R
v
L
S
S
S
S
S
c
"}
(10,1,1) = {"
C
q
q
q
q
q
p
v
v
v
L
S
S
S
S
t
C
"}
(11,1,1) = {"
a
a
a
f
a
a
a
r
r
r
a
S
S
S
S
S
d
"}
(12,1,1) = {"
b
T
y
q
m
F
a
q
q
q
a
S
S
S
S
S
a
"}
(13,1,1) = {"
a
Y
q
q
q
N
a
q
q
q
a
S
S
S
S
S
a
"}
(14,1,1) = {"
C
q
q
q
q
q
q
q
q
q
q
S
S
S
S
S
C
"}
(15,1,1) = {"
a
o
q
q
q
N
a
V
V
V
a
S
S
S
S
S
a
"}
(16,1,1) = {"
b
X
K
q
q
F
a
j
V
j
a
S
S
S
S
S
P
"}
(17,1,1) = {"
d
O
a
C
a
O
a
C
d
C
a
O
a
C
a
O
d
"}
