//MAP CONVERTED BY dmm2tgm.py THIS HEADER COMMENT PREVENTS RECONVERSION, DO NOT REMOVE
"bj" = (
/obj/item/storage/backpack/duffelbag/syndie/surgery,
/obj/structure/table,
/turf/open/floor/pod/dark,
/area/misc/survivalpod)
"bn" = (
/obj/machinery/light/directional/east,
/obj/structure/closet/crate,
/obj/item/circuitboard/machine/protolathe/offstation,
/obj/item/circuitboard/machine/circuit_imprinter/offstation,
/turf/open/floor/pod/dark,
/area/misc/survivalpod)
"bM" = (
/obj/machinery/computer/operating,
/turf/open/floor/pod/dark,
/area/misc/survivalpod)
"cM" = (
/obj/machinery/recharge_station,
/turf/open/floor/pod/dark,
/area/misc/survivalpod)
"dN" = (
/obj/structure/table/wood/fancy/black,
/obj/machinery/microwave,
/turf/open/floor/pod/dark,
/area/misc/survivalpod)
"fW" = (
/obj/machinery/light/directional/east,
/turf/open/floor/plating,
/area/misc/survivalpod)
"gG" = (
/turf/open/floor/pod/dark,
/area/misc/survivalpod)
"ha" = (
/obj/machinery/vending/snack/blue,
/turf/open/floor/pod/dark,
/area/misc/survivalpod)
"hS" = (
/obj/machinery/light/directional/south,
/turf/open/floor/plating,
/area/misc/survivalpod)
"hX" = (
/obj/item/kirbyplants/random,
/turf/open/floor/pod/dark,
/area/misc/survivalpod)
"iE" = (
/obj/machinery/autolathe/hacked,
/turf/open/floor/pod/dark,
/area/misc/survivalpod)
"lS" = (
/obj/effect/turf_decal/mining/survival,
/turf/closed/wall/mineral/titanium/survival/pod,
/area/misc/survivalpod)
"lV" = (
/obj/machinery/button/door{
	id = syndie_pod_door
	},
/turf/closed/wall/mineral/titanium/survival/pod,
/area/misc/survivalpod)
"pJ" = (
/obj/effect/turf_decal/mining/survival{
	dir = 1
	},
/turf/closed/wall/mineral/titanium/survival/pod,
/area/misc/survivalpod)
"qI" = (
/obj/machinery/teleport/syndicate_gate,
/obj/machinery/light/floor,
/turf/open/floor/engine,
/area/misc/survivalpod)
"rc" = (
/obj/effect/turf_decal/stripes,
/obj/machinery/door/poddoor/shutters/syndicate{
	id = syndie_pod_door
	},
/turf/open/floor/engine,
/area/misc/survivalpod)
"sb" = (
/obj/machinery/stasis{
	dir = 4
	},
/turf/open/floor/pod/dark,
/area/misc/survivalpod)
"so" = (
/obj/effect/turf_decal/stripes{
	dir = 4
	},
/obj/machinery/door/poddoor/shutters/syndicate{
	dir = 4;
	id = syndie_pod_door
	},
/turf/open/floor/engine,
/area/misc/survivalpod)
"sw" = (
/turf/closed/wall/mineral/titanium/survival/pod,
/area/misc/survivalpod)
"sx" = (
/obj/effect/turf_decal/mining/survival{
	dir = 4
	},
/turf/closed/wall/mineral/titanium/survival/pod,
/area/misc/survivalpod)
"sA" = (
/obj/structure/table,
/obj/item/storage/medkit/o2{
	pixel_x = 3;
	pixel_y = 3
	},
/obj/item/storage/medkit,
/turf/open/floor/pod/dark,
/area/misc/survivalpod)
"sQ" = (
/obj/structure/table,
/obj/item/storage/medkit/toxin{
	pixel_x = 3;
	pixel_y = 3
	},
/obj/item/storage/medkit/brute,
/obj/item/storage/medkit/fire{
	pixel_x = -3;
	pixel_y = -3
	},
/turf/open/floor/pod/dark,
/area/misc/survivalpod)
"uw" = (
/obj/structure/table/reinforced,
/obj/machinery/recharger,
/turf/open/floor/pod/dark,
/area/misc/survivalpod)
"uN" = (
/obj/structure/table/wood/fancy/black,
/obj/item/reagent_containers/cup/glass/shaker,
/obj/item/reagent_containers/cup/rag,
/obj/item/book/manual/wiki/barman_recipes,
/turf/open/floor/pod/dark,
/area/misc/survivalpod)
"vB" = (
/obj/machinery/porta_turret/syndicate/energy,
/turf/closed/wall/mineral/titanium/survival/pod,
/area/misc/survivalpod)
"wW" = (
/obj/structure/table/wood/fancy/black,
/obj/item/storage/box/donkpockets,
/obj/item/storage/box/donkpockets/donkpockethonk,
/obj/item/storage/box/donkpockets/donkpocketpizza,
/obj/item/storage/box/donkpockets/donkpocketspicy,
/obj/item/storage/box/donkpockets/donkpocketberry,
/turf/open/floor/pod/dark,
/area/misc/survivalpod)
"xR" = (
/obj/machinery/door/airlock/highsecurity,
/turf/open/floor/pod/dark,
/area/misc/survivalpod)
"AF" = (
/obj/structure/window/reinforced/survival_pod/spawner/directional/west,
/obj/structure/window/reinforced/survival_pod/spawner/directional/east,
/obj/structure/window/reinforced/survival_pod/spawner/directional/north,
/obj/structure/window/reinforced/survival_pod/spawner/directional/south,
/obj/structure/grille,
/turf/open/space/basic,
/area/misc/survivalpod)
"CR" = (
/obj/structure/closet/crate,
/obj/item/stack/sheet/glass/fifty,
/obj/item/stack/sheet/glass/fifty,
/obj/item/stack/sheet/glass/fifty,
/obj/item/stack/sheet/glass/fifty,
/turf/open/floor/pod/dark,
/area/misc/survivalpod)
"DI" = (
/obj/structure/table,
/obj/item/defibrillator/loaded{
	pixel_y = 3
	},
/turf/open/floor/pod/dark,
/area/misc/survivalpod)
"EG" = (
/obj/effect/turf_decal/mining/survival{
	dir = 8
	},
/turf/closed/wall/mineral/titanium/survival/pod,
/area/misc/survivalpod)
"EM" = (
/obj/machinery/vending/cigarette,
/turf/open/floor/pod/dark,
/area/misc/survivalpod)
"FJ" = (
/obj/machinery/light/directional/west,
/obj/machinery/suit_storage_unit/standard_unit,
/turf/open/floor/pod/dark,
/area/misc/survivalpod)
"GG" = (
/obj/effect/turf_decal/mining/survival{
	dir = 8
	},
/turf/closed/wall/mineral/titanium/survival/nodiagonal,
/area/misc/survivalpod)
"Hx" = (
/obj/structure/table/wood/fancy/black,
/obj/machinery/chem_dispenser/drinks/beer,
/turf/open/floor/pod/dark,
/area/misc/survivalpod)
"Jh" = (
/obj/structure/closet/crate,
/obj/item/stack/cable_coil/thirty,
/obj/item/storage/toolbox/syndicate,
/obj/item/storage/toolbox/syndicate,
/turf/open/floor/pod/dark,
/area/misc/survivalpod)
"JN" = (
/obj/effect/turf_decal/stripes{
	dir = 1
	},
/obj/machinery/door/poddoor/shutters/syndicate{
	dir = 1;
	id = syndie_pod_door
	},
/turf/open/floor/engine,
/area/misc/survivalpod)
"KZ" = (
/obj/item/stack/cable_coil/thirty,
/turf/open/floor/pod/dark,
/area/misc/survivalpod)
"Nk" = (
/turf/open/floor/plating,
/area/misc/survivalpod)
"Pv" = (
/obj/machinery/vending/boozeomat,
/turf/open/floor/pod/dark,
/area/misc/survivalpod)
"Py" = (
/obj/machinery/light/directional/north,
/turf/open/floor/pod/dark,
/area/misc/survivalpod)
"PF" = (
/obj/structure/closet/crate,
/obj/item/stack/sheet/mineral/gold{
	amount = 50
	},
/obj/item/stack/sheet/mineral/plasma{
	amount = 50
	},
/obj/item/stack/sheet/mineral/silver{
	amount = 50
	},
/obj/item/stack/sheet/mineral/uranium{
	amount = 50
	},
/turf/open/floor/pod/dark,
/area/misc/survivalpod)
"Rq" = (
/obj/structure/bed/medical,
/turf/open/floor/pod/dark,
/area/misc/survivalpod)
"Rs" = (
/turf/open/floor/engine,
/area/misc/survivalpod)
"SK" = (
/obj/structure/table/reinforced,
/obj/item/radio/headset/syndicate/alt,
/obj/item/radio/headset/syndicate/alt,
/turf/open/floor/pod/dark,
/area/misc/survivalpod)
"Ua" = (
/obj/structure/table/optable,
/obj/machinery/defibrillator_mount/directional/west,
/turf/open/floor/pod/dark,
/area/misc/survivalpod)
"UH" = (
/obj/structure/fans/tiny,
/obj/machinery/door/airlock/survival_pod/glass,
/turf/open/floor/carpet/black,
/area/misc/survivalpod)
"Vd" = (
/obj/structure/table/wood/fancy/black,
/obj/machinery/chem_dispenser/drinks,
/turf/open/floor/pod/dark,
/area/misc/survivalpod)
"Wj" = (
/obj/structure/window/reinforced/survival_pod/spawner/directional/west,
/obj/structure/window/reinforced/survival_pod/spawner/directional/east,
/obj/structure/window/reinforced/survival_pod/spawner/directional/north,
/obj/structure/window/reinforced/survival_pod/spawner/directional/south,
/obj/structure/grille,
/turf/open/floor/pod/dark,
/area/misc/survivalpod)
"WX" = (
/obj/machinery/light/directional/west,
/turf/open/floor/plating,
/area/misc/survivalpod)
"Xh" = (
/obj/structure/closet/crate,
/obj/item/storage/part_replacer/bluespace/tier3,
/obj/item/storage/part_replacer/bluespace/tier3,
/turf/open/floor/pod/dark,
/area/misc/survivalpod)
"Xq" = (
/obj/effect/turf_decal/stripes{
	dir = 8
	},
/obj/machinery/door/poddoor/shutters/syndicate{
	dir = 8;
	id = syndie_pod_door
	},
/turf/open/floor/engine,
/area/misc/survivalpod)
"Xu" = (
/obj/machinery/light/directional/east,
/obj/structure/closet/crate,
/obj/item/stack/sheet/iron/fifty,
/obj/item/stack/sheet/iron/fifty,
/obj/item/stack/sheet/iron/fifty,
/obj/item/stack/sheet/iron/fifty,
/turf/open/floor/pod/dark,
/area/misc/survivalpod)
"XN" = (
/obj/machinery/button/door{
	id = syndie_pod_door
	},
/turf/open/floor/engine,
/area/misc/survivalpod)

(1,1,1) = {"
vB
EG
sw
Wj
sw
EG
sw
Wj
vB
Wj
sw
EG
sw
Wj
sw
GG
vB
"}
(2,1,1) = {"
pJ
Vd
gG
gG
gG
ha
sw
FJ
gG
FJ
sw
Nk
Nk
WX
Nk
Nk
sw
"}
(3,1,1) = {"
sw
Hx
gG
gG
gG
dN
sw
uw
gG
uw
sw
Nk
Nk
Nk
Nk
Nk
sw
"}
(4,1,1) = {"
Wj
Py
gG
gG
gG
gG
gG
gG
gG
gG
gG
Nk
Nk
Nk
Nk
Nk
Wj
"}
(5,1,1) = {"
sw
Pv
gG
gG
gG
wW
sw
SK
gG
SK
sw
Nk
Nk
Nk
Nk
Nk
sw
"}
(6,1,1) = {"
pJ
uN
gG
gG
gG
EM
sw
cM
gG
cM
sw
Nk
Nk
Nk
Nk
Nk
sw
"}
(7,1,1) = {"
sw
sw
sw
xR
sw
sw
sw
Xq
Xq
Xq
lV
Nk
Nk
Nk
Nk
Nk
vB
"}
(8,1,1) = {"
Wj
gG
gG
gG
gG
gG
JN
Rs
Rs
Rs
rc
Nk
Nk
Nk
Nk
hS
AF
"}
(9,1,1) = {"
vB
Py
gG
gG
gG
gG
JN
Rs
qI
Rs
rc
Nk
Nk
Nk
Nk
Nk
UH
"}
(10,1,1) = {"
Wj
gG
gG
gG
gG
gG
JN
Rs
Rs
XN
rc
Nk
Nk
Nk
Nk
hS
Wj
"}
(11,1,1) = {"
sw
sw
sw
xR
sw
sw
sw
so
so
so
sw
Nk
Nk
Nk
Nk
Nk
vB
"}
(12,1,1) = {"
pJ
bM
Ua
gG
sb
hX
sw
KZ
gG
gG
sw
Nk
Nk
Nk
Nk
Nk
sw
"}
(13,1,1) = {"
sw
bj
gG
gG
gG
Rq
sw
iE
KZ
gG
sw
Nk
Nk
Nk
Nk
Nk
sw
"}
(14,1,1) = {"
Wj
Py
gG
gG
gG
gG
gG
gG
gG
gG
gG
Nk
Nk
Nk
Nk
Nk
Wj
"}
(15,1,1) = {"
sw
sQ
gG
gG
gG
Rq
sw
CR
Xh
Jh
sw
Nk
Nk
Nk
Nk
Nk
sw
"}
(16,1,1) = {"
pJ
sA
DI
gG
gG
hX
sw
Xu
PF
bn
sw
Nk
Nk
fW
Nk
Nk
lS
"}
(17,1,1) = {"
vB
sx
sw
Wj
sw
sx
sw
Wj
vB
Wj
sw
sx
sw
Wj
sw
sx
vB
"}
